lab1
An Interactive Fiction by ktaschek
Release 1 / Serial number 250416 / Inform 7 v10.1.2 / D

room1

Everything seems normal, and the room is as you would expect it to be.
You can see an Iron Door, a board and a jagged knife here.

>check sanity
Sanity Level: 2
Current Location: room1
Current Room Sanity: 2

* * *

>check sanity
Sanity Level: 2
Current Location: room2
Current Room Sanity: 2

>s
room1

>sanity down
Your mind trembles.

>check sanity
Sanity Level: 1
Current Location: room1
Current Room Sanity: 2

>sanity down
Your mind trembles.

>check sanity
Sanity Level: 0
Current Location: room1
Current Room Sanity: 2

>n
room2

* * *

>check sanity
Sanity Level: 2
Current Location: room2
Current Room Sanity: 2

>sanity down
Your mind trembles.

>s
room1

>check sanity
Sanity Level: 1
Current Location: room1
Current Room Sanity: 2

>l
room1

* * *

>s
room1

>l
room1

>check sanity
Sanity Level: 1
Current Location: room1
Current Room Sanity: 2

* * *

>l
room2

>check sanity
Sanity Level: 2
Current Location: room2
Current Room Sanity: 2

* * *

>l
room1

>check sanity
Sanity Level: 2
Current Location: room1
Current Room Sanity: 2

>sanity down
Your mind trembles.

>n
Something feels off as you step into the room2.

* * *

lab1
An Interactive Fiction by ktaschek
Release 1 / Serial number 250416 / Inform 7 v10.1.2 / D

room1

Everything seems normal, and the room is as you would expect it to be.
You can see an Iron Door, a board and a jagged knife here.

>l
Everything seems normal, and the room is as you would expect it to be.

>l
room1
You can see an Iron Door, a board and a jagged knife here.

>take knife
Taken.

* * *

>l
Everything seems normal, and the room is as you would expect it to be.

>n
room2
You can see a lever here.

>increasing sanity
That's not a verb I recognise.

>sanity up
You feel more composed.

>s
room1

* * *

>sanity down
Your mind trembles.

>n
room2

>l
room2

>s
room1

* * *

>sanity down
Your mind trembles.

>sanity down
Your mind trembles.

* * *

>n
room2

>n
You can't go that way.

* * *

>n
room2
You can see a lever here.

>take lever
Taken.

>l
room2

>i
You are carrying:
  a lever

>e
room3

>n
room4
You can see a wire A, a wire B, a wire C and a socket here.

>attach lever
The lever latches into place

>connect A
(the wire A)
You connect the wire A.

>connect B
You connect the wire B.
Sparks fly as the connections fizzle out! The wires reset.

>connect A
(the wire A)
You connect the wire A.

>connect C
You connect the wire C.

>connect B
You connect the wire B.
A satisfying click sounds as the wires align perfectly.

* * *

>l
room4
You can see a lever, a wire A, a wire B, a wire C and a socket here.

>pull
What do you want to pull?

* * *

>l
Everything seems normal, and the room is as you would expect it to be.

>restart
Are you sure you want to restart?

>yes
lab1
An Interactive Fiction by ktaschek
Release 1 / Serial number 250415 / Inform 7 v10.1.2 / D

hello
Everything seems normal, and the room is as you would expect it to be.

>take knife
Taken.

>l
Everything seems normal, and the room is as you would expect it to be.

>take knife
Taken.

>restart
Are you sure you want to restart?

>yes
lab1
An Interactive Fiction by ktaschek
Release 1 / Serial number 250415 / Inform 7 v10.1.2 / D

Everything seems normal, and the room is as you would expect it to be.

>take knife
Taken.

You try to get up, but your legs betray you. In an instant you collapse back onto the floor-the impact jostles your head. The world seems to shift, as if seen through unfamiliar eyes.

* * *

lab1
An Interactive Fiction by ktaschek
Release 1 / Serial number 250416 / Inform 7 v10.1.2 / D

room1

Everything seems normal, and the room is as you would expect it to be.
You can see an Iron Door, a board and a jagged knife here.

>n
A whispers tells you "look ..."

You try to get up, but your legs betray you. In an instant you collapse back onto the floor-the impact jostles your head. The world seems to shift, as if seen through unfamiliar eyes.
everything feels fuzzy, but as your headache softens, you notice everything seems off

I beg your pardon?

>l
room2

* * *

>n
A whispers tells you "look ..."

You try to get up, but your legs betray you. In an instant you collapse back onto the floor-the impact jostles your head. The world seems to shift, as if seen through unfamiliar eyes.
everything feels fuzzy, but as your headache softens, you notice everything seems off

>check sanity
Sanity Level: 2
Current Location: room2
Current Room Sanity: 2

>sanity up
You feel more composed.

>check sanity
Sanity Level: 2
Current Location: room2
Current Room Sanity: 2

* * *

>sanity down
Your mind trembles.

>check sanity
Sanity Level: 0
Current Location: room2
Current Room Sanity: 2

>s
Something feels off as you step into the room1.

room1

* * *

>n
A whispers tells you "look ..."

You try to get up, but your legs betray you. In an instant you collapse back onto the floor-the impact jostles your head. The world seems to shift, as if seen through unfamiliar eyes.
everything feels fuzzy, but as your headache softens, you notice everything seems off

>e
Something feels off as you step into the room3.

room3

The room appears distorted and hazy, as though viewed through a fog of uncertainty.
You can see a lockedDoor here.

>e
(first opening the lockedDoor)
It seems to be locked.

"You look pale," the doctor murmurs. "How are you holding up?"
your head starts cloudy and your headache worsens, but things seem more normal

I beg your pardon?

>n
room4
You can see a wire A, a wire B, a wire C and a socket here.

>s
room3
You can see a lockedDoor here.

>w
room2
You can see a lever here.

>pick up lever
Taken.

>e
room3
You can see a lockedDoor here.

>n
room4
You can see a wire A, a wire B, a wire C and a socket here.

>connect A
(the wire A)
You connect the wire A.

* * *

>connect B
You connect the wire B.
A satisfying click sounds as the wires align perfectly.

>attach leve
You can't see any such thing.

>attach lever
The lever latches into place

>pull lever
You pull the lever and the mechanism hums to life. The wires glow with energy. You here something unlock
Nothing obvious happens.

>s
room3
You can see a lockedDoor here.

>e
(first opening the lockedDoor)

room5
You can see a lockedDoor here.

* * *

>e
Something feels off as you step into the room3.

room3

The room appears distorted and hazy, as though viewed through a fog of uncertainty.
You can see a lockedDoor here.

>n
room4
You can see a wire A, a wire B, a wire C and a socket here.

>s
room3

>w
room2
You can see a lever here.

* * *

>pick up lever
Taken.

>e
room3

* * *

>attach lever
The lever latches into place

>pull
What do you want to pull?

>lever
You pull the lever, but nothing happens. The wires don't seem to be connected properly.

Nothing obvious happens.

>connect a
(the wire A)
You connect the wire A.

>connect b
You connect the wire B.
Sparks fly as the connections fizzle out! The wires reset.

>connect a
(the wire A)
You connect the wire A.

>connect c
You connect the wire C.

>connect b
You connect the wire B.
A satisfying click sounds as the wires align perfectly.

>pull lever
You pull the lever and the mechanism hums to life. The wires glow with energy.

Nothing obvious happens.

* * *

>e
Something feels off as you step into the room3.

room3

The room appears distorted and hazy, as though viewed through a fog of uncertainty.
You can see a lockedDoor here.

>w
Something feels off as you step into the room2.

room2

The room appears distorted and hazy, as though viewed through a fog of uncertainty.
You can see a lever here.

"You look pale," the doctor murmurs. "How are you holding up?"
your head starts cloudy and your headache worsens, but things seem more normal

>pick up lever
Taken.

* * *

>n
room4
You can see a wire A, a wire B, a wire C and a socket here.

>connect a
(the wire A)
You connect the wire A.

* * *

>connect b
You connect the wire B.
A satisfying click sounds as the wires align perfectly.

>attach lever
The lever latches into place

* * *

>pull lever
You pull the lever and the mechanism hums to life. The wires glow with energy. You here something unlock
Nothing obvious happens.

>s
room3
You can see a lockedDoor here.

A distant click echoes as you notice the boarded door creak open...

>e
(first opening the lockedDoor)

room5
You can see a lockedDoor, a doctor and an altar here.

>lay on altar
I didn't understand that sentence.

>lay down on altar
*** The End ***

Would you like to RESTART, RESTORE a saved game, QUIT or UNDO the last command?

* * *

>w
Something feels off as you step into the room2.

room2

The room appears distorted and hazy, as though viewed through a fog of uncertainty.
You can see a lever here.

"You look pale," the doctor murmurs. "How are you holding up?"
your head starts cloudy and your headache worsens, but things seem more normal

>take lever
Taken.

>e
Something feels off as you step into the room3.

room3

Everything seems normal, and the room is as you would expect it to be.
You can see a lockedDoor here.

>n
room4

Everything seems normal, and the room is as you would expect it to be.
You can see a wire A, a wire B, a wire C and a socket here.

>connect a
(the wire A)
You connect the wire A.

* * *

>pull lever
You pull the lever and the mechanism hums to life. The wires glow with energy. You here something unlock
Nothing obvious happens.

>s
room3

Everything seems normal, and the room is as you would expect it to be.
You can see a lockedDoor here.

A distant bang echoes, ringing your ears as the a shotgun blast followed by the clanging of a door falling permeates through the area. Your head is somehow less foggy

>e
(first opening the lockedDoor)

room5

Everything seems normal, and the room is as you would expect it to be.
You can see a lockedDoor, a doctor and an altar here.

* * *

>n
A whispers tells you "look ..."

You try to get up, but your legs betray you. In an instant you collapse back onto the floor-the impact jostles your head. The world seems to shift, as if seen through unfamiliar eyes.
everything feels fuzzy, but as your headache softens, you notice everything seems off

>e\
That's not a verb I recognise.

>e
"Have you seen the painting" the voice whispers

>w
Something feels off as you step into the room2.

room2

The room appears distorted and hazy, as though viewed through a fog of uncertainty.
You can see a lever here.

"You look pale," the doctor murmurs. "How are you holding up?"
your head starts cloudy and your headache worsens, but things seem more normal

>e
room3

Everything seems normal, and the room is as you would expect it to be.
You can see a lockedDoor here.

>n
room4

Everything seems normal, and the room is as you would expect it to be.
You can see a wire A, a wire B, a wire C and a socket here.

>s
room3

Everything seems normal, and the room is as you would expect it to be.
You can see a lockedDoor here.

* * *

>n
A whispers tells you "look ..."

You try to get up, but your legs betray you. In an instant you collapse back onto the floor-the impact jostles your head. The world seems to shift, as if seen through unfamiliar eyes.
everything feels fuzzy, but as your headache softens, you notice everything seems off

>pick up lever
Taken.

* * *

>attach lever
The lever latches into place

>pull lever
You pull the lever and the mechanism hums to life. The wires glow with energy.

Nothing obvious happens.

>pull lever
You pull the lever and the mechanism hums to life. The wires glow with energy.

Nothing obvious happens.

>connect A
(the wire A)
You've already connected the wire A.

>s
room3

>e
room5

>l
room5

>restart
Are you sure you want to restart?

Please answer yes or no.

>yes
lab1
An Interactive Fiction by ktaschek
Release 1 / Serial number 250411 / Inform 7 v10.1.2 / D

room1
You can see a board here.

>n
room2
You can see a lever here.

>e
room3

>e
room5

>e
You can't go that way.

* * *

>n
A whispers tells you "look ..."

You try to get up, but your legs betray you. In an instant you collapse back onto the floor-the impact jostles your head. The world seems to shift, as if seen through unfamiliar eyes.
everything feels fuzzy, but as your headache softens, you notice everything seems off

>s
room1

>n
room2

>sanity down
Your mind trembles.

* * *

>n
A whispers tells you "look ..."

You try to get up, but your legs betray you. In an instant you collapse back onto the floor-the impact jostles your head. The world seems to shift, as if seen through unfamiliar eyes.
everything feels fuzzy, but as your headache softens, you notice everything seems off

>sanity up
You feel more composed.

>sanity down
Your mind trembles.

>s
Something feels off as you step into the room1.

room1

>n
Something feels off as you step into the room2.

room2

* * *

>n
A whispers tells you "look ..."

You try to get up, but your legs betray you. In an instant you collapse back onto the floor-the impact jostles your head. The world seems to shift, as if seen through unfamiliar eyes.
everything feels fuzzy, but as your headache softens, you notice everything seems off

>take lever
Taken.

>e
"Have you seen the painting" the voice whispers
"You look pale," the doctor murmurs. "How are you holding up?"
your head starts cloudy and your headache worsens, but things seem more normal

>n
room4

Everything seems normal, and the room is as you would expect it to be.
You can see a wire A, a wire B, a wire C and a socket here.

* * *

>pull lever
You pull the lever and the mechanism hums to life. The wires glow with energy. You here something unlock
Nothing obvious happens.

>s
room3

Everything seems normal, and the room is as you would expect it to be.
You can see a lockedDoor here.

>e
(first opening the lockedDoor)
With a heavy **clang**, the Steel Gate swings shut and locks itself automatically, rattling your head.
everything feels fuzzy, but as your headache softens, you notice everything seems off

>w
(first opening the lockedDoor)
It seems to be locked.

A distant bang echoes, ringing your ears as the a shotgun blast followed by the clanging of a door falling permeates through the area. Your head is somehow less foggy

>e
room5

Everything seems normal, and the room is as you would expect it to be.
You can see a lockedDoor, a doctor and an altar here.

* * *

lab1
An Interactive Fiction by ktaschek
Release 1 / Serial number 250416 / Inform 7 v10.1.2 / D

room1

Everything seems normal, and the room is as you would expect it to be.
You can see an Iron Door, a board and a jagged knife here.

>open door
A disembodied, stern voice whispers: "Do not open that door!"

>open door
A disembodied, stern voice whispers: "Do not open that door!"

>take board
Taken.

>board up door
You firmly nail the board to the Iron Door, reinforcing it and buying yourself extra time.

>take board
You can't see any such thing.

>open door
The Iron Door is nailed shut

* * *

lab1
An Interactive Fiction by ktaschek
Release 1 / Serial number 250416 / Inform 7 v10.1.2 / D

room1

Everything seems normal, and the room is as you would expect it to be.
You can see an Iron Door, a board and a jagged knife here.

>sanity down
Your mind trembles.

>n
Something feels off as you step into the room2.

room2

>s
Something feels off as you step into the room1.

room1

>n
room2

>s
room1

>check sanity
Sanity Level: 1
Current Location: room1
Current Room Sanity: 1

>n
room2

* * *

lab1
An Interactive Fiction by ktaschek
Release 1 / Serial number 250416 / Inform 7 v10.1.2 / D

room1

Everything seems normal, and the room is as you would expect it to be.
You can see an Iron Door, a board and a jagged knife here.

>take board
Taken.

>open door
You open the Iron Door.

* * *

lab1
An Interactive Fiction by ktaschek
Release 1 / Serial number 250416 / Inform 7 v10.1.2 / D

room1

Everything seems normal, and the room is as you would expect it to be.
You can see an Iron Door, a board and a jagged knife here.

>take knife
Taken.

You try to get up, but your legs betray you. In an instant you collapse back onto the floor-the impact jostles your head. The world seems to shift, as if seen through unfamiliar eyes.
everything feels fuzzy, but as your headache softens, you notice everything seems off

>attaclk hunter
That's not a verb I recognise.

>attack hunter
You can't see any such thing.

* * *

>take knife
Taken.

You try to get up, but your legs betray you. In an instant you collapse back onto the floor-the impact jostles your head. The world seems to shift, as if seen through unfamiliar eyes.
everything feels fuzzy, but as your headache softens, you notice everything seems off

>hit myself
Violence isn't the answer to this one.

>hit myself with the knife
I only understood you as far as wanting to hit yourself.

* * *

>take knife
Taken.

You try to get up, but your legs betray you. In an instant you collapse back onto the floor-the impact jostles your head. The world seems to shift, as if seen through unfamiliar eyes.
everything feels fuzzy, but as your headache softens, you notice everything seems off

>l
Everything seems normal, and the room is as you would expect it to be.

* * *

>take knife
Taken.

You try to get up, but your legs betray you. In an instant you collapse back onto the floor-the impact jostles your head. The world seems to shift, as if seen through unfamiliar eyes.
everything feels fuzzy, but as your headache softens, you notice everything seems off

>n
Something feels off as you step into the room2.

room2

The room appears distorted and hazy, as though viewed through a fog of uncertainty.
You can see a lever here.

>take lever
Taken.

"You look pale," the doctor murmurs. "How are you holding up?"
your head starts cloudy and your headache worsens, but things seem more normal

>n
You can't go that way.

>e
room3

Everything seems normal, and the room is as you would expect it to be.
You can see a lockedDoor here.

I beg your pardon?

>n
room4

Everything seems normal, and the room is as you would expect it to be.
You can see a wire A, a wire B, a wire C and a socket here.

* * *

>connect b
You connect the wire B.
A satisfying click sounds as the wires align perfectly.

>attach lever
The lever latches into place
A distant bang echoes, ringing your ears as the a shotgun blast followed by the clanging of a door falling permeates through the area. Your head is somehow less foggy

>pull lever
You pull the lever and the mechanism hums to life. The wires glow with energy. You here something unlock
Nothing obvious happens.

>s
room3

Everything seems normal, and the room is as you would expect it to be.
You can see a hunter and a lockedDoor here.

>l
room3

Everything seems normal, and the room is as you would expect it to be.
You can see a hunter and a lockedDoor here.

The hunter looms ominously. You have 4 turns left before he strikes!

>talk to hunter
"Be careful out here-wolves have been spotted," the hunter warns.

The hunter looms ominously. You have 3 turns left before he strikes!

>talk to hunter
"You look like you could use some provisions. I've got extra arrows," he offers.

The hunter looms ominously. You have 2 turns left before he strikes!

>open door
You can't see any such thing.

>e
(first opening the lockedDoor)

room5

Everything seems normal, and the room is as you would expect it to be.
You can see a lockedDoor, a doctor and an altar here.

>w
room3

Everything seems normal, and the room is as you would expect it to be.
You can see a lockedDoor and a hunter here.

The hunter looms ominously. You have 1 turn left before he strikes!

* * *

>take knife
Taken.

You try to get up, but your legs betray you. In an instant you collapse back onto the floor-the impact jostles your head. The world seems to shift, as if seen through unfamiliar eyes.
everything feels fuzzy, but as your headache softens, you notice everything seems off

>stab
(yourself)
Violence isn't the answer to this one.

* * *

>l
room1
You can see a board here.

>z
Time passes.

>z
Time passes.

I beg your pardon?

>z
Time passes.

>z
Time passes.

A distant click echoes as you notice the boarded door creak open...

The hunter looms ominously. You have 4 turns left before he strikes!

>z
Time passes.

The hunter looms ominously. You have 3 turns left before he strikes!

>z
Time passes.

The hunter looms ominously. You have 2 turns left before he strikes!

>z
Time passes.

The hunter looms ominously. You have 1 turn left before he strikes!

>z
Time passes.

The hunter looms ominously. You have 0 turns left before he strikes!
Before you can act, the hunter pounces-your fate is sealed!

    *** The End ***

Would you like to RESTART, RESTORE a saved game, QUIT or UNDO the last command?

* * *

lab1
An Interactive Fiction by ktaschek
Release 1 / Serial number 250416 / Inform 7 v10.1.2 / D

room1

Everything seems normal, and the room is as you would expect it to be.
You can see an Iron Door, a board and a jagged knife here.

>x door
You see nothing special about the Iron Door.

You try to get up, but your legs betray you. In an instant you collapse back onto the floor-the impact jostles your head. The world seems to shift, as if seen through unfamiliar eyes.
everything feels fuzzy, but as your headache softens, you notice everything seems off

>n
A whispers tells you "look ..."

>e
"Have you seen the painting" the voice whispers
"You look pale," the doctor murmurs. "How are you holding up?"
your head starts cloudy and your headache worsens, but things seem more normal

>e
(first opening the Sealed Door)
It seems to be locked.

>examine door
You see nothing special about the Sealed Door.

* * *

lab1
An Interactive Fiction by ktaschek
Release 1 / Serial number 250416 / Inform 7 v10.1.2 / D

room1

Everything seems normal, and the room is as you would expect it to be.
You can see an Iron Door, a board and a jagged knife here.

>z
Time passes.

>l
Everything seems normal, and the room is as you would expect it to be.

>take
What do you want to take?

* * *

I beg your pardon?

I beg your pardon?

* * *

>z
Time passes.

The hunter looms ominously. You have 3 turns left before he strikes!

I beg your pardon?

>z
Time passes.

The hunter looms ominously. You have 2 turns left before he strikes!

* * *

>z
Time passes.

The hunter looms ominously. You have 0 turns left before he strikes!
Before you can act, the hunter pounces-your fate is sealed!

    *** The End ***

Would you like to RESTART, RESTORE a saved game, QUIT or UNDO the last command?

>restart
lab1
An Interactive Fiction by ktaschek
Release 1 / Serial number 250411 / Inform 7 v10.1.2 / D

room1
You can see a board here.

>z
Time passes.

>n
room2
You can see a lever here.

>pick up lever
Taken.

* * *

>s
room3
You can see a lockedDoor here.

A distant click echoes as you notice the boarded door creak open...

>z
Time passes.

The hunter arrives from the west.

The hunter looms ominously. You have 4 turns left before he strikes!

>l
room3
You can see a hunter and a lockedDoor here.

The hunter looms ominously. You have 3 turns left before he strikes!

>l
room3
You can see a hunter and a lockedDoor here.

The hunter looms ominously. You have 2 turns left before he strikes!

>e
(first opening the lockedDoor)

room5
You can see a lockedDoor here.

>l
room5
You can see a lockedDoor here.

>l
room5
You can see a lockedDoor here.

>z
Time passes.

>z
Time passes.

"You look pale," the doctor murmurs. "How are you holding up?"

>z
Time passes.

>z
Time passes.

A distant click echoes as you notice the boarded door creak open...

>z
Time passes.

* * *

>z
Time passes.

The hunter looms ominously. You have 3 turns left before he strikes!

>n
room2
You can see a lever here.

The hunter arrives from the south.

The hunter looms ominously. You have 2 turns left before he strikes!

>z
Time passes.

The hunter looms ominously. You have 1 turn left before he strikes!

>e
room3
You can see a lockedDoor here.

The hunter arrives from the west.

The hunter looms ominously. You have 0 turns left before he strikes!
Before you can act, the hunter pounces-your fate is sealed!

    *** The End ***

Would you like to RESTART, RESTORE a saved game, QUIT or UNDO the last command?